1, 18, 4, 8, 39,28, 4,35, 11,18, 10,56, 5,
1, 74, 4, 7, 42,80, 4,108, 10,74, 9,115, 5,
0, 170, 4, 8, 7,171, 4,172, 11,170, 7,176, 9,
0, 9, 20, 8, 46,11, 20,24, 27,9, 26,54, 21,
0, 71, 20, 8, 23,86, 20,86, 27,71, 25,93, 24,
0, 161, 21, 7, 17,167, 21,168, 27,161, 26,177, 24,
0, 8, 36, 7, 29,29, 36,34, 42,8, 37,36, 40,
0, 0, 0, 0, 0,0, 0,0, 0,0, 0,0, 0,
0, 0, 0, 0, 0,0, 0,0, 0,0, 0,0, 0,
