1, 19, 4, 8, 17,34, 4,30, 11,19, 10,35, 6,
1, 77, 5, 7, 40,92, 5,114, 11,77, 6,116, 6,
0, 136, 4, 7, 16,149, 4,150, 10,136, 6,151, 9,
0, 11, 20, 7, 7,16, 20,14, 26,11, 21,17, 21,
0, 68, 21, 7, 21,71, 21,70, 27,68, 26,88, 25,
0, 128, 20, 8, 17,135, 20,140, 27,128, 26,144, 25,
0, 23, 36, 7, 20,38, 36,35, 42,23, 40,42, 39,
0, 69, 37, 7, 44,75, 37,100, 43,69, 38,112, 42,
0, 138, 36, 8, 28,141, 36,151, 43,138, 39,165, 37,
