1, 6, 4, 8, 46,17, 4,49, 11,6, 8,51, 9,
1, 65, 5, 7, 52,78, 5,99, 11,65, 10,116, 10,
0, 144, 4, 8, 11,148, 4,153, 11,144, 5,154, 9,
0, 12, 21, 7, 34,22, 21,16, 27,12, 24,45, 24,
0, 67, 21, 7, 27,79, 21,87, 27,67, 24,93, 24,
0, 146, 20, 8, 15,152, 20,153, 27,146, 21,160, 22,
0, 9, 36, 8, 47,51, 36,41, 43,9, 40,55, 41,
0, 66, 37, 7, 35,88, 37,69, 43,66, 40,100, 38,
0, 133, 36, 7, 36,149, 36,137, 42,133, 41,168, 37,
