1, 31, 4, 8, 25,32, 4,41, 11,31, 7,55, 7,
0, 66, 4, 7, 30,88, 4,84, 10,66, 9,95, 8,
0, 127, 5, 7, 42,136, 5,163, 11,127, 10,168, 6,
0, 25, 20, 8, 30,40, 20,26, 27,25, 22,54, 24,
0, 67, 20, 7, 45,90, 20,93, 26,67, 22,111, 23,
0, 139, 20, 8, 9,140, 20,145, 27,139, 24,147, 22,
0, 5, 36, 7, 44,32, 36,25, 42,5, 41,48, 38,
0, 106, 36, 8, 12,110, 36,113, 43,106, 38,117, 39,
0, 127, 36, 8, 51,142, 36,142, 43,127, 38,177, 38,
