1, 9, 4, 8, 46,34, 4,46, 11,9, 9,54, 6,
0, 87, 4, 8, 19,98, 4,103, 11,87, 5,105, 10,
0, 146, 4, 7, 32,170, 4,176, 10,146, 7,177, 5,
0, 22, 21, 7, 16,34, 21,36, 27,22, 22,37, 26,
0, 70, 20, 7, 24,82, 20,85, 26,70, 21,93, 25,
0, 143, 21, 7, 12,144, 21,149, 27,143, 22,154, 24,
0, 18, 36, 8, 9,25, 36,25, 43,18, 41,26, 41,
0, 73, 36, 8, 42,96, 36,90, 43,73, 37,114, 38,
0, 137, 36, 8, 29,163, 36,139, 43,137, 41,165, 39,
