1, 4, 4, 8, 53,53, 4,48, 11,4, 5,56, 6,
0, 100, 4, 8, 15,103, 4,107, 11,100, 9,114, 9,
0, 134, 4, 8, 16,138, 4,140, 11,134, 9,149, 8,
1, 16, 21, 7, 16,28, 21,26, 27,16, 22,31, 22,
1, 68, 20, 8, 42,71, 20,94, 27,68, 25,109, 21,
1, 145, 20, 8, 27,165, 20,147, 27,145, 25,171, 25,
0, 25, 36, 8, 19,32, 36,34, 43,25, 39,43, 40,
0, 70, 36, 7, 18,72, 36,77, 42,70, 37,87, 41,
0, 128, 37, 7, 48,135, 37,173, 43,128, 39,175, 39,
