1, 45, 4, 8, 7,50, 4,49, 11,45, 9,51, 9,
0, 78, 5, 7, 37,86, 5,97, 11,78, 9,114, 9,
0, 128, 4, 7, 48,148, 4,137, 10,128, 6,175, 6,
0, 12, 21, 7, 44,52, 21,52, 27,12, 23,55, 22,
0, 86, 20, 8, 26,88, 20,88, 27,86, 24,111, 25,
0, 141, 21, 7, 35,145, 21,165, 27,141, 26,175, 23,
0, 10, 36, 7, 41,27, 36,28, 42,10, 37,50, 38,
0, 75, 37, 7, 39,92, 37,101, 43,75, 41,113, 39,
0, 134, 37, 7, 42,142, 37,168, 43,134, 40,175, 38,
