1, 9, 5, 7, 48,20, 5,33, 11,9, 8,56, 8,
0, 67, 4, 8, 18,79, 4,78, 11,67, 6,84, 6,
0, 165, 4, 8, 8,166, 4,166, 11,165, 9,172, 7,
0, 13, 20, 8, 41,14, 20,14, 27,13, 23,53, 26,
0, 89, 20, 8, 10,90, 20,94, 27,89, 21,98, 21,
0, 139, 20, 8, 21,149, 20,154, 27,139, 23,159, 22,
0, 8, 36, 8, 48,54, 36,39, 43,8, 39,55, 37,
0, 74, 36, 7, 37,85, 36,109, 42,74, 39,110, 41,
0, 148, 36, 8, 28,155, 36,158, 43,148, 37,175, 40,
