1, 5, 4, 8, 32,14, 4,17, 11,5, 9,36, 5,
1, 65, 4, 8, 33,83, 4,80, 11,65, 6,97, 9,
1, 128, 4, 8, 49,154, 4,136, 11,128, 6,176, 6,
1, 10, 21, 7, 40,44, 21,20, 27,10, 25,49, 24,
1, 75, 20, 8, 32,79, 20,77, 27,75, 22,106, 26,
1, 160, 20, 7, 16,172, 20,167, 26,160, 22,175, 25,
0, 4, 36, 7, 42,14, 36,9, 42,4, 40,45, 39,
1, 73, 37, 7, 29,76, 37,94, 43,73, 39,101, 39,
1, 151, 36, 8, 13,152, 36,154, 43,151, 41,163, 41,
