1, 5, 4, 8, 15,7, 4,10, 11,5, 9,19, 9,
0, 68, 4, 8, 47,107, 4,105, 11,68, 9,114, 9,
0, 140, 5, 7, 24,154, 5,145, 11,140, 7,163, 9,
0, 4, 20, 8, 49,24, 20,17, 27,4, 24,52, 23,
0, 73, 21, 7, 45,78, 21,114, 27,73, 24,117, 23,
0, 126, 20, 8, 31,144, 20,153, 27,126, 25,156, 25,
0, 18, 36, 8, 36,31, 36,29, 43,18, 40,53, 38,
0, 69, 37, 7, 24,90, 37,73, 43,69, 40,92, 39,
0, 135, 37, 7, 40,154, 37,151, 43,135, 41,174, 39,
